1110111
1110111
1110111
1110111
1110111
1110111
1110111
1000001
1400401
1111101
1400001
1101111
1100401
1111101
1400001
1110111
1040451
1311111
1111111
1111111
1111111
1111111
1111111
1111111
1111111
