1110111
1110111
1110111
1110111
1110111
1110111
1110111
1000001
1040401
1011101
1001001
1000001
1000001
1000001
1000001
1302031
1111011
1000001
1000001
1000001
1043401
1011101
1000001
1000001
1000001
1000001
1300031
1100011
1000001
1000001
1000001
1000001
1000001
1000001
1000001
1000001
1000001
1000001
1000001
1000001
1500231
1111111
1111111
1111111
1111111
1111111
1111111
1111111
1111111
