1110111
1110111
1110111
1110111
1110111
1110111
1110111
1000001
1040241
1011111
1204001
1111001
1007001
1040431
1011111
1404061
1111701
1000431
1040111
1011111
1400401
1111101
1117401
1110111
1020401
1311101
1111101
1042041
1011111
1400111
1110111
1040001
1011331
1011111
1400401
1111101
1110401
1110111
1024701
1311001
1110701
1000031
1040411
1011111
1040401
1111101
1110401
1110111
1020401
1311101
1111101
1040041
1011111
1404011
1111011
1040701
1011331
1011111
1400401
1111101
1110401
1110111
1020461
1311101
1111101
1000601
1454001
1111111
1111111
1111111
1111111
1111111
1111111
1111111
1111111
1111111
