1110111
1110111
1110111
1110111
1110111
1110111
1110111
1000001
1040401
1011101
1340421
1110111
1040001
1011101
1046001
1110001
1062001
1011001
1070001
1040331
1110111
1040111
1011111
1001111
1000111
1000011
1700011
1320411
1110111
1110111
1000001
1007001
1330441
1110111
1000071
1070001
1330441
1110111
1110111
1000001
1007001
1030401
1011101
1066601
1000701
1700001
1000081
1320331
1110111
1104201
1001101
1000001
1700031
1330011
1110211
1110111
1110111
1040001
1011101
1406031
1110111
1002401
1011101
1306041
1110111
1040401
1011101
1400031
1100011
1008001
1000701
1080001
1000001
1320431
1110111
1110111
1000001
1007001
1320431
1110111
1004001
1011101
1008001
1000801
1320431
1110111
1040401
1011101
1404501
1111131
1111111
1111111
1111111
1111111
1111111
1111111
1111111
1111111
