1110111
1110111
1110111
1110111
1110111
1110111
1110111
1000001
1470401
1111101
1110401
1110111
1040111
1011111
1001111
1000111
1007001
1000001
1320431
1110111
1004111
1001111
1070001
1700001
1330001
1110421
1110111
1114001
1111001
1007001
1000801
1400331
1110111
1120401
1111101
1111001
1110001
1107001
1000001
1040231
1110111
1140001
1111001
1000701
1007001
1000331
1400111
1110111
1040401
1011101
1046201
1011101
1062001
1011101
1070001
1400331
1110111
1040111
1011111
1001111
1000111
1007001
1000001
1320431
1110111
1000411
1001111
1070001
1700001
1330011
1110421
1110111
1000001
1454001
1111131
1111111
1111111
1111111
1111111
1111111
1111111
1111111
1111111
1111111
