1110111
1110111
1110111
1110111
1110111
1110111
1110111
1000001
1200401
1111101
1111001
1000001
1000001
1000001
1500231
1111111
1111111
1111111
1111111
1111111
1111111
1111111
1111111
