1110111
1110111
1110111
1110111
1110111
1110111
1110111
1000001
1040401
1011101
1340421
1110111
1004211
1001111
1000011
1700011
1330011
1110211
1110111
1110111
1110111
1000001
1007001
1030401
1010111
1060661
1000701
1700001
1000081
1320431
1110111
1040111
1011111
1404601
1111101
1062041
1001111
1070001
1340431
1110111
1040111
1011111
1001111
1000111
1000011
1700011
1320411
1110111
1040001
1011101
1406031
1110111
1002401
1011101
1306041
1110111
1110001
1111001
1000701
1008001
1000331
1401111
1140111
1110111
1040401
1011101
1400031
1100011
1008001
1000801
1080001
1008001
1320431
1110111
1040401
1011101
1046201
1011101
1062001
1011101
1700001
1400331
1110111
1110101
1000701
1407011
1110001
1004041
1401111
1100111
1000001
1070001
1000001
1300431
1110111
1042601
1011101
1070001
1330401
1110111
1000001
1454001
1111131
1111111
1111111
1111111
1111111
1111111
1111111
1111111
1111111
1111111
