1110111
1110111
1110111
1110111
1110111
1110111
1110111
1000001
1500041
1110011
1000001
1011101
1000001
1000001
1000001
1000001
1320041
1110111
1504011
1111311
1111111
1111111
1111111
1111111
1111111
1111111
