1110111
1110111
1110111
1110111
1110111
1110111
1110111
1000001
1200001
1111101
1111001
1000001
1000001
1000001
1320231
1110111
1020001
1011101
1000201
1011101
1000001
1011101
1000001
1200331
1110111
1000001
1330001
1110111
1002001
1011111
1001111
1000001
1000001
1000001
1320031
1110111
1000001
1011101
1020001
1011101
1000001
1020331
1110111
1000021
1011111
1001111
1000001
1000001
1000001
1300031
1110111
1000001
1011101
1020201
1011101
1000001
1330021
1110111
1000001
1111101
1111001
1000001
1000001
1000001
1320031
1110111
1000001
1011101
1002001
1011101
1002001
1011101
1000001
1000331
1110111
1000001
1330021
1110111
1000001
1011111
1001111
1000001
1000001
1000001
1320031
1110111
1000001
1011101
1002001
1011101
1000001
1011101
1000001
1020331
1110111
1000001
1330001
1110111
1002001
1011111
1001111
1000001
1000001
1000001
1300031
1110111
1000001
1111111
1111111
1111111
1111111
1111111
1111111
1111111
