1110111
1110111
1110111
1110111
1110111
1110111
1110111
1000001
1040241
1011111
1204001
1111001
1007001
1040431
1011111
1070001
1111001
1000431
1040111
1011111
1407401
1111101
1110401
1110111
1020401
1311101
1111101
1007001
1011111
1000111
1110111
1000001
1011331
1011111
1007001
1111101
1110401
1110111
1027401
1311001
1110001
1000031
1000111
1011111
1000001
1111101
1110401
1110111
1020401
1311101
1111101
1000001
1011111
1000111
1110111
1000001
1011331
1011111
1000001
1111101
1110401
1110111
1020401
1311101
1111101
1000001
1454001
1111111
1111111
1111111
1111111
1111111
1111111
1111111
1111111
1111111
