1110111
1110111
1110111
1110111
1110111
1110111
1110111
1000001
1040241
1011111
1040111
1110111
1110111
1000001
1007001
1030301
1010101
1060601
1000701
1700001
1000081
1320431
1110111
1114011
1111011
1040701
1011331
1011111
1440111
1110111
1110111
1000001
1007001
1330441
1110111
1000071
1070001
1340331
1110111
1040111
1011111
1046001
1111101
1062041
1001111
1070001
1340431
1110111
1110001
1111001
1000701
1008001
1000331
1401111
1140111
1110111
1004001
1011101
1008001
1000801
1320431
1110111
1110401
1111101
1046601
1011111
1066001
1111001
1000001
1008001
1240031
1110111
1640461
1011101
1070001
1008001
1300031
1170011
1108011
1043401
1011101
1200041
1110111
1100011
1104311
1001111
1740011
1310011
1110011
1140311
1110111
1000001
1005401
1001111
1331111
1111111
1111111
1111111
1111111
1111111
1111111
1111111
1111111
