1110111
1110111
1110111
1110111
1110111
1110111
1110111
1100001
1120401
1111101
1111001
1100001
1107001
1100001
1140231
1110111
1040401
1011101
1064201
1011101
1700001
1040331
1110111
1040621
1011111
1001111
1000111
1007011
1800011
1330411
1110111
1060401
1011101
1024601
1011101
1070001
1333401
1111101
1040421
1011111
1001111
1000001
1000001
1800001
1340241
1110111
1040401
1011101
1024601
1011101
1070001
1330401
1110111
1114001
1111101
1111001
1000001
1000701
1080001
1320431
1110111
1040401
1011101
1062401
1011101
1060401
1011101
1000001
1400331
1110111
1000001
1330441
1110111
1040111
1011111
1001111
1000001
1007001
1000001
1340431
1110111
1062401
1011101
1000001
1400331
1110111
1000001
1420331
1110111
1000001
1040451
1311111
1111111
1111111
1111111
1111111
1111111
1111111
1111111
1111111
1111111
