1110111
1110111
1110111
1110111
1110111
1110111
1110111
1000001
1200401
1111101
1111001
1000001
1007001
1000001
1340231
1110111
1020471
1011101
1046201
1011101
1064001
1011101
1700001
1240331
1110111
1000011
1330411
1110111
1040621
1011111
1001111
1000001
1070001
1000001
1320431
1110111
1060401
1011101
1020401
1011101
1070001
1330441
1110111
1040421
1011111
1001111
1000001
1000701
1800001
1340431
1110111
1040401
1011101
1020601
1011101
1070001
1330401
1110111
1114001
1111101
1111001
1000001
1000701
1080001
1320031
1110111
1000401
1011101
1002001
1011101
1042001
1011101
1000001
1400331
1110111
1000001
1330021
1110111
1000041
1011111
1001111
1000001
1007001
1000001
1320031
1110111
1062401
1011101
1000001
1420331
1110111
1000001
1330041
1110111
1000001
1040451
1311111
1111111
1111111
1111111
1111111
1111111
1111111
1111111
1111111
1111111
