1110111
1110111
1110111
1110111
1700001
1404201
1111101
1040401
1011111
1020401
1111101
1600041
1700011
1040401
1311101
1111101
1600001
1042041
1011111
1400111
1110111
1100011
1080001
1400201
1111101
1040401
1011111
1042401
1011101
1400041
1110111
1000061
1500401
1111131
1111111
1111111
1111111
1111111
1111111
1111111
1111111
1111111
1111111
