1110111
1110111
1110111
1110111
1110111
1110111
1110111
1000001
1500421
1101111
1s40401
1111101
10400s1
1011111
1000001
1140411
1110111
1660661
1200021
1100011
104j401
1011101
1000001
1000001
100w001
1000001
1s00021
1100011
104j401
1011101
104r401
1011101
1s00001
1000001
100w001
1s00001
1200041
1100011
100j041
1311111
1111111
1111111
1111111
1111111
1111111
1111111
