1110111
1110111
1110111
1110111
1110111
1110111
1110111
1000001
1040401
1011101
1000001
1070001
1808001
1000001
1000001
1302031
1111011
1000001
1008001
1000001
1043401
1011101
1000001
1080001
1000801
1000001
1300031
1100011
1000001
1007001
1000001
1080001
1000001
1000701
1000001
1110111
1070001
1008001
1000001
1040401
1011101
1000001
1070001
1808001
1000001
1000001
1302031
1111011
1000001
1008001
1000001
1043401
1011101
1000001
1080001
1000801
1000001
1300031
1100011
1000001
1007001
1000001
1084001
1011101
1000701
1000001
1110111
1070001
1008001
1000071
1007001
1500201
1111131
1111111
1111111
1111111
1111111
1111111
1111111
1111111


1110111
1110111
1110111
1110111
1110111
1110111
1110111
1000001
1480201
1111101
1040401
1011111
1020401
1111101
1400041
1110111
1040401
1311101
1111101
1600001
1042041
1011111
1400111
1110111
1100011
1000061
1400201
1111101
1040401
1011111
1042401
1011101
1400041
1110111
1000061
1500401
1111131
1111111
1111111
1111111
1111111
1111111
1111111
1111111
