1110111
1110111
1110111
1110111
1110111
1110111
1110111
1000001
1080001
1240401
1111101
1110241
1110111
1110001
1111001
1000701
1008001
1000331
1401111
1140111
1110111
1004211
1001111
1000011
1700011
1330011
1110211
1110111
1110111
1040401
1011101
1046201
1011101
1062001
1011101
1070001
1400331
1110111
1040401
1011101
1400031
1100011
1800001
1000081
1008001
1800001
1320431
1110111
1040111
1011111
1046001
1111101
1062041
1011111
1070001
1040331
1110111
1040111
1011111
1001111
1000111
1000011
1700011
1320411
1110111
1004001
1011101
1008001
1000801
1320431
1110111
1110401
1111101
1111001
1110001
1107001
1100701
1140431
1110111
1110401
1111101
1640641
1011111
1464001
1111001
1000001
1008001
1240031
1110111
1110001
1111001
1000701
1008001
1000331
1401111
1140111
1110111
1004211
1001111
1000011
1700011
1330011
1110211
1110111
1110111
1040401
1011101
1454001
1111131
1111111
1111111
1111111
1111111
1111111
1111111
1111111
1111111
1111111
