1110111
1110111
1110111
1110111
1110111
1110111
1110111
1000001
1204041
1111011
1060201
1011111
1001111
1000041
1000011
1000001
1320041
1110111
1504011
1111311
1111111
1111111
1111111
1111111
1111111
1111111
