1110111
1110111
1110111
1110111
1110111
1110111
1110111
1000001
1042401
1011101
1000001
1700001
1000081
1000001
1900001
1000001
1000001
1440441
1110111
1600061
1040401
1011101
1405431
1111111
1111111
1111111
1111111
1111111
1111111
1111111
1111111
1111111
1111111

1340421
1110111
1110401
1111101
1046601
1011111
1066001
1111001
1000001
1008001
1240031
1110111
1040111
1011111
1046001
1111101
1062041
1011111
1070001
1040331
1110111
1004211
1001111
1000011
1700011
1330011
1110211
1110111
1110001
1111001
1000701
1008001
1000331
1401111
1140111
1110111
1044001
1011101
1024601
1011101
1064001
1011101
1002601
1001101
1330401
1110111
1004001
1011101
1008001
1000801
1320431
1110111
1114011
1111011
1040701
1011331
1011111
1440111
1110111
1040401
1011101
1046201
1011101
1062001
1011101
1070001
1400331
1110111
1000001
1454001
1111131
1111111
1111111
1111111
1111111
1111111
1111111
1111111
1111111
1111111
