1110111
1110111
1110111
1110111
1110111
1110111
1110111
1000001
1470401
1111101
1110241
1110111
1040111
1011111
1040601
1111101
1642041
1011111
1470111
1110111
1004211
1001111
1000011
1700011
1330011
1110211
1110111
1040001
1011101
1406031
1110111
1040111
1011111
1470111
1110111
1110401
1040131
1310111
1110201
1040131
1310111
1110111
1110111
1000001
1007001
1030301
1010101
1040401
1011101
1700001
1800081
1320431
1110111
1110111
1000001
1007001
1330441
1110111
1000071
1070001
1330441
1110111
1110111
1000001
1007001
1320431
1110111
1040401
1011101
1000001
1000801
1320431
1110111
1100061
1145401
1111111
1111111
1111111
1111111
1111111
1111111
1111111
1111111
1111111
1111111
