1110111
1110111
1110111
1110111
1110111
1110111
1110111
1000001
1040401
1011101
1000001
1070001
1808001
1000001
1000001
1302031
1111011
1000001
1008001
1000001
1043401
1011101
1000001
1080001
1000801
1000001
1300031
1100011
1000001
1007001
1000001
1080001
1000001
1000701
1340431
1110111
1670061
1008001
1000001
1040401
1011101
1466641
1100011
104r401
1011101
1206431
1110111
1070001
1800001
1000001
1008001
1342031
1111011
1000001
1008001
1000001
1043401
1011101
1006001
1080001
1000801
1700001
1304j41
1101111
1000001
1307001
1100001
1040401
1011101
1000701
1330041
1110111
1070001
1008001
1000071
1007001
1540j41
1111111
1111111
1111111
1111111
1111111
1111111
1111111
1111111
1111111
1111111
