1110111
1110111
1110111
1110111
1110111
1110111
1110111
1600061
1200401
1111101
1111001
1400041
1110111
1040511
1311111
1111111
1111111
1111111
1111111
1111111
1111111
1111111
