1110111
1110111
1110111
1110111
1110111
1110111
1110111
1000001
1040401
1011101
1000001
1070001
1808001
1000001
1000001
1302031
1111011
1000001
1008001
1000001
1043401
1011101
1000001
1080001
1000801
1000001
1300031
1100011
1000001
1007001
1000001
1080001
1000001
1000701
1000001
1110111
1070001
1008001
1000001
1040401
1011101
1000001
1070001
1808001
1000001
1000001
1302031
1111011
1000001
1008001
1000001
1043401
1011101
1000001
1080001
1000801
1000001
1300031
1100011
1000001
1007001
1000001
1084001
1011101
1000701
1000001
1110111
1070001
1008001
1000071
1007001
1500201
1111131
1111111
1111111
1111111
1111111
1111111
1111111
1111111
1111111
1111111
