#START1
1110111
1110111
1110111
1110111
1110111
1110111
1110111
1000001
1470401
1111101
1110241
1110111
#START2
1110111
1110111
1110111
1110111
1110111
1110111
1110111
1000001
1040241
1011111
1040111
1110111
#START3
1110111
1110111
1110111
1110111
1110111
1110111
1110111
1000001
1040401
1011101
1340421
1110111

#MODULAR1
1004001
1011101
1008001
1000801
1320431
1110111
#MODULAR2
1110401
1111101
1111001
1110001
1107001
1100701
1140431
1110111
#MODULAR3
1040111
1011111
1001111
1000111
1000011
1700011
1320411
1110111
#MODULAR4
1110001
1111001
1000701
1008001
1000331
1401111
1140111
1110111
#MODULAR5
1004211
1001111
1000011
1700011
1330011
1110211
1110111
1110111
#MODULAR6
1040401
1011101
1046201
1011101
1062001
1011101
1070001
1400331
1110111
#MODULAR7
1040111
1011111
1046001
1111101
1062041
1011111
1070001
1040331
1110111
#MODULAR8
1110401
1111101
1046601
1011111
1066001
1111001
1000001
1008001
1240031
1110111
#MODULAR9
1040401
1011101
1400031
1100011
1008001
1000801
1080001
1008001
1320431
1110111
#MODULAR10
1114011
1111011
1040701
1011331
1011111
1440111
1110111
#MODULAR11
1004111
1001111
1070001
1704401
1331101
1111001
1110241
1110111
#MODULAR12
1040001
1011101
1406031
1110111
1002401
1011101
1306041
1110111
#MODULAR13
1110111
1000001
1007001
1330441
1110111
1000071
1070001
1330441
1110111
#MODULAR14
1110111
1000001
1007001
1030301
1010101
1060601
1000701
1700001
1000081
1320431
1110111
#MODULAR15
1110111
1114611
1111011
1116411
1110111
1162111
1101111
1140111
1110111
#MODULAR16
1640461
1011101
1070001
1008001
1300031
1170011
1108011
1043411
1011101
1200041
1110111
#MODULAR17
1100011
1104311
1001111
1740011
1310011
1110011
1140311
1110111
#MODULAR18
1040111
1011111
1470111
1110111
1110401
1040131
1310111
1110201
1040131
1310111
1110111
#MODULAR19
1110401
1111101
1110041
1110111
1640111
1310471
1110131
1040111
1310261
1110131
1110111
#MODULAR20
1044001
1011101
1024601
1011101
1064001
1011101
1002601
1001101
1330401
1110111


#END1
1000001
1045401
1111111
1111111
1111111
1111111
1111111
1111111
1111111
1111111
1111111
1111111
#END2
1000001
1454001
1111131
1111111
1111111
1111111
1111111
1111111
1111111
1111111
1111111
1111111
#END3
1040401
1011101
1454001
1111131
1111111
1111111
1111111
1111111
1111111
1111111
1111111
1111111
1111111
