1110111
1110111
1110111
1110111
1110111
1110111
1110111
1000001
1250401
1111101
1111001
1000001
1007001
1000001
1340231
1110111
1020001
1011101
1046201
1011101
1064001
1011101
1000001
1200331
1110111
1000001
1330041
1110111
1042601
1011111
1001111
1000001
1070001
1000001
1320031
1110111
1060401
1011101
1020001
1011101
1000001
1420331
1110111
1040421
1011111
1001111
1000001
1000001
1800001
1300031
1110111
1000401
1011101
1020201
1011101
1000001
1330021
1110111
1404001
1111101
1111001
1000001
1000001
1000001
1320031
1110111
1000401
1011101
1002001
1011101
1042001
1011101
1000001
1400331
1110111
1000001
1330021
1110111
1000041
1011111
1001111
1000001
1007001
1000001
1320031
1110111
1040001
1011101
1002001
1011101
1004001
1011101
1000001
1020331
1110111
1000001
1330041
1110111
1002001
1011111
1001111
1000001
1007001
1800001
1300041
1110111
1000001
1040451
1311111
1111111
1111111
1111111
1111111
1111111
1111111
1111111
1111111
1111111
